传奇来了	整个地图只有你一人 装备都归你 
悬空城手游	技术大大已病倒 只为这款游戏 也是醉了  
仙傲八荒	斥资5亿只为打造完美场景 魔界 人界 仙界极致体验 
最游记物语 5V5版	零负担游戏 碎片时间 精简日常 梦幻良心回合  
修真诀	3年烧了8个亿 这手游终于上线 画风唯美 装备全靠打  
侠影录	妹子成功渡劫 进入化神期 竟收服了神宠  
传奇暴击版	华为玩家三天满级 全身毕业 制霸全服 4M安装包极速体验 
梦幻之翼	开局抓了个飞龙 养了3天技能爆表  
主宰沙城 注册就送	3年烧9个亿 另类传奇手游 装备全靠打 注册送装备  
血狱沙城	小屋砍猪 伤害翻倍 爆率翻倍 人人都想进屋  
国之战魂	今日三国卡牌策略大作上线了 赶紧把游戏制作人拉出去奖励一个亿  
刀剑逍遥	上班挂机 下班卖装 连云港妹子外快到手 
夺塔传奇  	三国塔防 考验你的智商极限 
移领	战法道 终极PK 谁才是王道  
极品芝麻官	向前走 天天拉着犯人做苦工 玩这游戏好爽 
复古76完美复刻  	单机版传奇 所有装备全靠打 
达趣科技	解锁了赵云 一个能打十个 
羽衣狐传说	老公痴迷这款仙侠手游 画面太美太惊艳 
梦幻家园iOS	这游戏突然在肇庆火了 熬夜都在玩的三消游戏 
拇指互娱	统兵30万 你来布阵一统三国 
仙境传说	我可能玩了假游戏 妹子多 装备全靠打 坐骑野外抓  
王者传奇 加强版	拿着带有刀魂性质的屠龙刀 就算是道士看到你也要跑 
传奇来了	千人PK 万人站巷 经典再现 来了才知道 
决战艾泽拉斯IOS 魔兽	国外付费 128的魔兽手游 登录中国9月8日限免 
心跳牛牛官方APP	六人牛牛 每人两副牌在线PK 超刺激  本地人都爱玩 
大天使H5 转职觉醒	你的兄弟转职觉醒后 就变成你的老婆了 有点方  
航海王 启航	七武海助战 开启航海新篇章  
百乐捕鱼爆机	这捕鱼停不下来 男人3分钟着迷 女人5分钟爱不释手 
上古风云决v1 6 3	150级开启撩妹技能 看你功力如何  
青云剑仙	龙之玄幻 等你收服 
